###############
#  ##       #B#
#      ##   # #
####  ### # # #
#       # ### #
#  # # ##     #
#  #A#    ### #
###############