##########
#    #B  #
# # #### #
#A#      #
##########