##############
#           B#
# ########## #
#     #   ## #
### # # # ## #
### # # # ## #
###A#   #    #
##############