#####################
#                  B#
# ################# #
#     #   #   #   # #
### # # # # # # # # #
### # # # # # # # # #
###A#   #   #   #   #
#####################