###############
#   #B        #
#   # ####### #
#   #         #
#   # #########
#   #A#       #
###############